EA ./path_to_the_east_texture
WE ./path_to_the_west_texture
NO     ./path_to_the_north_texture
SO  ./path_to_the_south_texture
F    231, 90,90
C     121,1,120





        1111111111111111111
1111111110111111111111111 
1111111111111111111111111
1000000000110000000000001
1011000001110000000000001
1001000000000000000000111111111111
1111111111011000001110000000000001
1000000000110000011101111111111111
111101111100000010001
111101111101010010001
110000011100N00010001
11111111111111111111111
